1000000000000001
1000000000000001
1000000000000001
1000000000000001
1000000000000001
1000000000000001
1000000000000001
1000000000000001
1000000000000001
1000000000000001
1000000000000001
1000000000000001
1000000000000001
1001111111111001
1011110000000001
1000111100000001
1000001111110001
1000000001111001
1000000000111101
1001111111110001
1111111111111111
