1000000000000001
1000000000000001
1000000000000001
1000000000000001
1000000000000001
1000000000000001
1000000000000001
1000000000000001
1000000000000001
1000000000000001
1000000000000001
1000000000000001
1001111111111001
1001111111111001
1001111000111001
1001111111111001
1001111111111001
1001111011100001
1001111001111001
1001111000111101
1111111111111111
