1000000000000001
1000000000000001
1000000000000001
1000000000000001
1000000000000001
1000000000000001
1000000000000001
1000000000000001
1000000000000001
1000000000000001
1011110000111101
1000001111000001
1000001111000001
1000011111100001
1000000000000001
1011111111111101
1001111111111001
1000111111110001
1011110000111101
1011110000111101
1111111111111111
