1000000000000001
1000000000000001
1000000000000001
1000000000000001
1000000000000001
1000000000000001
1000000000000001
1000000000000001
1000000000000001
1000000000000001
1000000000000001
1000000000000001
1000000000000001
1000001111000001
1000001111000001
1011111111111101
1011111111111101
1000001111000001
1000001111000001
1000001111000001
1111111111111111
